   ########
   #      #
  ## ## # #
  #  $ $ $##
  # $$@##  ##
  ##  ###$  #
  ##   ## # #
###  #....  #
#  $##....###
# # ####  #
#  $      #
########  #
       ####