  #####
  #...###
  ##.$#.#
   #    #
#### $# #
#   # * #
#  $@$  #
####*$$ #
 #.     #
 ########