########################
#   .     $          . #
#                      #
#                      #
#   $     .        $   #
#@                     #
########################