########################
#   .                . #
#                      #
#                      #
#   $              $   #
#@                     #
########################