##########
#@      .#
#   $$  .#
#  $ $  .#
#  $ $  .#
#   $$  .#
#       .#
#       .#
#       .#
##########