#########################
#   .           .       #
#                       #
#                       #
#                       #
#                       #
#   $           $       #
#     @                 #
#########################