########
#   #  #
#  *.$@#
#.$*   #
###    #
  ######