########
#@  .  #
####$  #
   #   #
   #.$ #
   #####